111111111111111
1000000000001E1
100111110000101
100000C100C0101
100000010000101
1P0000010000001
111111111111111
